0,0,0,0,0,0,0,0,0,0,0,0,0,0,0,0,0,0
0,0,0,0,0,2,0,0,2,1,1,2,0,0,0,0,0,0
0,0,0,0,0,1,0,0,1,0,0,1,0,0,2,1,1,2
0,0,0,0,0,1,0,0,1,0,0,1,0,0,1,0,0,0
0,0,0,0,0,2,1,1,2,0,0,2,1,1,2,0,0,0
0,0,0,0,0,1,0,0,1,0,0,1,0,0,1,0,0,0
0,0,0,0,0,1,0,0,1,0,0,1,0,0,2,1,1,2
0,0,0,0,0,2,0,0,2,1,1,2,0,0,0,0,0,0
0,0,0,0,0,0,0,0,0,0,0,0,0,0,0,0,0,0
routes
17,6,LDLULDLU
17,2,LULDLULD